border_size=1
usage=map

Wo          , Wo          , Wo          , Wo          , Ww          , Ww          , Ww          , Ww          , Ww          , Wo          , Wo          , Ww          , Wo          , Wo          , Ww          , Ww          , Ww          , Ww          , Ww          , Wo          , Wo          , Ww          , Wo          , Wo          , Ww          , Ww          , Ww          , Ww          , Ww          , Wo          , Wo          , Wo          , Wo          
Wo          , Wo          , Ww          , Ww          , Mm^Xm       , Ww          , Mm^Xm       , Ww          , Mm^Xm       , Ww          , Ww          , Wo          , Ww          , Ww          , Mm^Xm       , Ww          , Mm^Xm       , Ww          , Mm^Xm       , Ww          , Ww          , Wo          , Ww          , Ww          , Mm^Xm       , Ww          , Mm^Xm       , Ww          , Mm^Xm       , Ww          , Ww          , Wo          , Wo          
Ww          , Ww          , Mm^Xm       , Mm^Xm       , Re^Gvs      , Mm^Xm       , Mm          , Mm^Xm       , Uu^Uf       , Mm^Xm       , Mm^Xm       , Ww          , Mm^Xm       , Mm^Xm       , Re^Gvs      , Mm^Xm       , Mm          , Mm^Xm       , Uu^Uf       , Mm^Xm       , Mm^Xm       , Ww          , Mm^Xm       , Mm^Xm       , Re^Gvs      , Mm^Xm       , Mm          , Mm^Xm       , Uu^Uf       , Mm^Xm       , Mm^Xm       , Ww          , Ww          
Ww          , Mm^Xm       , Md          , Gs          , Gs          , Gs          , Gs^Es       , Mm          , Gs^Ft       , Ss          , Chs         , Mm^Xm       , Mm          , Gs          , Gs          , Gs          , Gs^Es       , Mm          , Gs^Ft       , Ss          , Chs         , Mm^Xm       , Md          , Gs          , Gs          , Gs          , Gs^Es       , Mm          , Gs^Ft       , Ss          , Chs         , Mm^Xm       , Ww          
Ww          , Mm^Xm       , Gs          , Gg^Fet      , Gs          , Gs          , Gs          , Gs          , Ss^Vhs      , Ss          , Ss          , Mm^Xm       , Gs          , Gg^Fet      , Gs          , Gs          , Gs          , Gs          , Ss^Vhs      , Ss          , Ss          , Mm^Xm       , Gs          , Gg^Fet      , Gs          , Gs          , Gs          , Gs          , Ss^Vhs      , Ss          , Ss          , Mm^Xm       , Ww          
Ww          , Mm^Xm       , Dd^Do       , Gs          , Gs          , Rd          , Gs          , Gs          , Ww          , Ss          , Ds          , Mm^Xm       , Dd^Do       , Gs          , Gs          , Rd          , Gs          , Gs          , Ww          , Ss          , Ds          , Mm^Xm       , Dd^Do       , Gs          , Gs          , Rd          , Gs          , Gs          , Ww          , Ss          , Ds          , Mm^Xm       , Ww          
Ww          , Mm^Xm       , Dd          , Dd^Vda      , Gs          , Gs          , Ww          , Ww^Bw\      , Ww^Bw\      , Ww          , Gs^Fp       , Mm^Xm       , Dd          , Dd^Vda      , Gs          , Gs          , Ww          , Ww^Bw\      , Ww^Bw\      , Ww          , Gs^Fp       , Mm^Xm       , Dd          , Dd^Vda      , Gs          , Gs          , Ww          , Ww^Bw\      , Ww^Bw\      , Ww          , Gs^Fp       , Mm^Xm       , Ww          
Ww          , Mm^Xm       , Dd^Es       , Rd          , Hh          , Gs^Ft       , Ww          , Ww          , Hh^Fp       , Rb          , Gg          , Mm^Xm       , Dd^Es       , Rd          , Hh          , Gs^Ft       , Ww          , Ww          , Hh^Fp       , Rb          , Gg          , Mm^Xm       , Dd^Es       , Rd          , Hh          , Gs^Ft       , Ww          , Ww          , Hh^Fp       , Rb          , Gg          , Mm^Xm       , Ww          
Ww          , Mm^Xm       , Gs          , Rd          , Gs          , Gs^Es       , Ww          , Ww          , Gg          , Re          , Uu^Vu       , Mm^Xm       , Gs          , Rd          , Gs          , Gs^Es       , Ww          , Ww          , Gg          , Re          , Uu^Vu       , Mm^Xm       , Gs          , Rd          , Gs          , Gs^Es       , Ww          , Ww          , Gg          , Re          , Uu^Vu       , Mm^Xm       , Ww          
Ww          , Mm^Xm       , Rr^Vhc      , Rd          , Rd          , Ww          , Ww          , Wwrg        , Gg          , Uu^Uf       , Ur          , Mm^Xm       , Rr^Vhc      , Rd          , Rd          , Ww          , Ww          , Wwrg        , Gg          , Uu^Uf       , Ur          , Mm^Xm       , Rr^Vhc      , Rd          , Rd          , Ww          , Ww          , Wwrg        , Gg          , Uu^Uf       , Ur          , Mm^Xm       , Ww          
Ww          , Mm^Xm       , Chr         , Rr          , Rr          , Wwf         , Wwf         , Gs^Fp       , Gg          , Ur          , Mm^Xm       , Mm^Xm       , Chr         , Rr          , Rr          , Wwf         , Wwf         , Gs^Fp       , Gg          , Ur          , Mm^Xm       , Mm^Xm       , Chr         , Rr          , Rr          , Wwf         , Wwf         , Gs^Fp       , Gg          , Ur          , Mm^Xm       , Mm^Xm       , Ww          
Ww          , Rrc         , 4 Khr       , Chr         , Chw         , Wwf         , Hh          , Rp          , Rp          , Rp          , Mm^Xm       , Rrc         , 5 Khr       , Chr         , Chw         , Wwf         , Hh          , Rp          , Rp          , Rp          , Mm^Xm       , Rrc         , 6 Khr       , Chr         , Chw         , Wwf         , Hh          , Rp          , Rp          , Rp          , Mm          , Mm^Xm       , Ww          
Ww          , Mm^Xm       , Mm^Xm       , Chr         , Ww          , Ww          , Ww          , Gg          , Hh^Fp       , Rp          , Rp          , Mm^Xm       , Rp          , Chr         , Ww          , Ww          , Ww          , Gg          , Hh^Fp       , Rp          , Rp          , Mm^Xm       , Rp          , Chr         , Ww          , Ww          , Ww          , Gg          , Hh^Fp       , Gg          , Mm^Xm       , Mm^Xm       , Ww          
Wo          , Ww          , Ww          , Mm^Xm       , Mm^Xm       , Wwrg        , Ss          , Ss          , Mm^Xm       , Gg          , Gg          , Rp          , Gg          , Gg          , Mm^Xm       , Wwrg        , Ss          , Ss          , Mm^Xm       , Gg          , Gg          , Rp          , Gg          , Gg          , Mm^Xm       , Wwrg        , Ss          , Ss          , Mm^Xm       , Mm^Xm       , Ww          , Ww          , Wo          
Wo          , Wo          , Wo          , Ww          , Ww          , Mm^Xm       , Mm^Xm       , Mm^Xm       , Ww          , Mm^Xm       , Mm^Xm       , Mm^Xm       , Mm^Xm       , Mm^Xm       , Ww          , Mm^Xm       , Mm^Xm       , Mm^Xm       , Ww          , Mm^Xm       , Mm^Xm       , Mm^Xm       , Mm^Xm       , Mm^Xm       , Ww          , Mm^Xm       , Mm^Xm       , Mm^Xm       , Ww          , Ww          , Wo          , Wo          , Wo          
Wo          , Wo          , Wo          , Wo          , Wo          , Ww          , Ww          , Ww          , Ww          , Ww          , Ww          , Ww          , Ww          , Ww          , Ww          , Ww          , Ww          , Ww          , Ww          , Ww          , Ww          , Ww          , Ww          , Ww          , Ww          , Ww          , Ww          , Ww          , Wo          , Wo          , Wo          , Wo          , Wo          
