border_size=1
usage=map

_off^_usr   , _off^_usr   , _off^_usr   , _off^_usr   , _off^_usr   , _off^_usr   , _off^_usr   , _off^_usr   , _off^_usr   , _off^_usr   , _off^_usr   , _off^_usr   , _off^_usr   , _off^_usr   , _off^_usr   , _off^_usr   , _off^_usr   , _off^_usr   , _off^_usr   , _off^_usr   , _off^_usr   , _off^_usr   , _off^_usr   
_off^_usr   , _off^_usr   , _off^_usr   , _off^_usr   , _off^_usr   , _off^_usr   , _off^_usr   , _off^_usr   , _off^_usr   , _off^_usr   , Xv          , Xv          , Xv          , _off^_usr   , _off^_usr   , _off^_usr   , _off^_usr   , _off^_usr   , _off^_usr   , _off^_usr   , _off^_usr   , _off^_usr   , _off^_usr   
_off^_usr   , _off^_usr   , _off^_usr   , _off^_usr   , _off^_usr   , _off^_usr   , _off^_usr   , _off^_usr   , Xv          , Xv          , Ce          , 4 Ke        , Ce          , Xv          , Xv          , _off^_usr   , _off^_usr   , _off^_usr   , _off^_usr   , _off^_usr   , _off^_usr   , _off^_usr   , _off^_usr   
_off^_usr   , _off^_usr   , _off^_usr   , _off^_usr   , _off^_usr   , _off^_usr   , Xv          , Xv          , Wwf         , Ww          , Ww          , Ce          , Gg          , Gg          , Gg          , Xv          , Xv          , _off^_usr   , _off^_usr   , _off^_usr   , _off^_usr   , _off^_usr   , _off^_usr   
_off^_usr   , _off^_usr   , _off^_usr   , _off^_usr   , Xv          , Xv          , Wwf         , Wwf         , Gs^Vht      , Gs          , Ww^Bw/      , Ce          , Gg          , Gg^Vc       , Gg          , Gg          , Gg^Es       , Xv          , Xv          , _off^_usr   , _off^_usr   , _off^_usr   , _off^_usr   
_off^_usr   , _off^_usr   , Xv          , Xv          , Aa^Vca      , Ww          , Gs          , Hh          , Rp          , Rp          , Gs          , Ww          , Gg          , Gg          , Gg          , Gs^Fms      , Gg          , Hh          , Aa^Fma      , Xv          , Xv          , _off^_usr   , _off^_usr   
_off^_usr   , Xv          , Ha          , Aa          , Aa          , Ww^Bw/      , Ds          , Gs          , Ss^Bw|      , Gs^Ft       , Ds          , Wwf         , Hh          , Gs^Fms      , Ww^Bw|      , Gg^Es       , Ww          , Gg          , Gg          , Aa          , Ha          , Xv          , _off^_usr   
_off^_usr   , Xv          , Aa          , Aa^Fma      , Wwf         , Ww          , Ss          , Ss          , Khs         , Ss          , Ss          , Ww          , Ww          , Ww          , Khw         , Ww          , Mm^Xm       , Wwf         , Wwf         , Aa^Fma      , Aa          , Xv          , _off^_usr   
_off^_usr   , Xv          , Aa^Fma      , Gg          , Wwf         , Ss          , Mm^Xm       , Ss          , Ss          , Ss          , Ss^Vm       , Ww          , Ds          , Gg          , Hh          , Ww          , Mm^Xm       , Ss          , Ww          , Aa          , Aa^Vca      , Xv          , _off^_usr   
_off^_usr   , Xv          , Hh          , Gg          , Ww          , Mm^Xm       , Ww          , Mm^Xm       , Mm^Xm       , Ss          , Ww          , Wwf         , Mm^Xm       , Mm^Vhh      , Mm^Xm       , Mm^Xm       , Ss          , Ss          , Ds          , Ww^Bw|      , Ww          , Xv          , _off^_usr   
_off^_usr   , Xv          , Gg^Es       , Gg          , Gg^Es       , Ww          , Khw         , Hh          , Mm^Vhh      , Mm^Xm       , Ww          , Mm^Xm       , Ww          , Mm^Xm       , Ss          , Ss          , Khs         , Ss          , Gs          , Gs          , Wwf         , Xv          , _off^_usr   
_off^_usr   , Xv          , Gg          , Gs^Fms      , Gg          , Ww^Bw/      , Ww          , Gg          , Ds          , Mm^Xm       , Mm^Xm       , Ww          , Mm^Xm       , Ww          , Ss^Vm       , Ss          , Ss          , Ss^Bw\      , Rr          , Hh          , Wwf         , Xv          , _off^_usr   
_off^_usr   , Xv          , Gg          , Gg          , Gg          , Gs^Fms      , Hh          , Ww          , Ww          , Wwf         , Ww          , Ww          , Mm^Xm       , Wwf         , Ww          , Ss          , Ds          , Gs^Ft       , Rr          , Gs^Vht      , Wwf         , Xv          , _off^_usr   
_off^_usr   , Xv          , Gg          , Gg^Vc       , Gg          , Gg          , Wwf         , Ww          , Ss          , Ss^Vm       , Ss          , Mm^Xm       , Mm^Vhh      , Ds          , Ww          , Ww          , Wwf         , Gs          , Ww^Bw|      , Gs          , Ww          , Xv          , _off^_usr   
_off^_usr   , Xv          , Ce          , Gg          , Ce          , Ww          , Gs          , Ds          , Ss          , Ss          , Ss          , Mm^Xm       , Hh          , Gg          , Ww          , Hh          , Gg          , Ww          , Ce          , Ww          , Ce          , Xv          , _off^_usr   
_off^_usr   , Xv          , 2 Ke        , Ce          , Ww          , Ww^Bw\      , Rp          , Gs^Ft       , Ss^Bw/      , Khs         , Ss          , Mm^Xm       , Ww          , Khw         , Ww^Bw\      , Gs^Fms      , Gg          , Gg          , Gg          , Ce          , 3 Ke        , Xv          , _off^_usr   
_off^_usr   , Xv          , Xv          , Ce          , Ww          , Gs          , Gs^Vht      , Rp          , Gs          , Ss          , Ss          , Mm^Xm       , Mm^Xm       , Ww          , Gg^Es       , Gg          , Gg          , Gg^Vc       , Gg          , Ce          , Xv          , Xv          , _off^_usr   
_off^_usr   , _off^_usr   , _off^_usr   , Xv          , Xv          , Wwf         , Wwf         , Hh          , Gs          , Ds          , Ww          , Ss          , Wwf         , Ww          , Gg          , Gs^Fms      , Gg          , Gg          , Xv          , Xv          , _off^_usr   , _off^_usr   , _off^_usr   
_off^_usr   , _off^_usr   , _off^_usr   , _off^_usr   , _off^_usr   , Xv          , Xv          , Wwf         , Ww          , Ww^Bw\      , Aa          , Wwf         , Gg          , Gg          , Hh          , Gg^Es       , Xv          , Xv          , _off^_usr   , _off^_usr   , _off^_usr   , _off^_usr   , _off^_usr   
_off^_usr   , _off^_usr   , _off^_usr   , _off^_usr   , _off^_usr   , _off^_usr   , _off^_usr   , Xv          , Xv          , Aa^Vca      , Aa          , Aa^Fma      , Aa          , Aa^Fma      , Xv          , Xv          , _off^_usr   , _off^_usr   , _off^_usr   , _off^_usr   , _off^_usr   , _off^_usr   , _off^_usr   
_off^_usr   , _off^_usr   , _off^_usr   , _off^_usr   , _off^_usr   , _off^_usr   , _off^_usr   , _off^_usr   , _off^_usr   , Xv          , Xv          , Ha          , Xv          , Xv          , _off^_usr   , _off^_usr   , _off^_usr   , _off^_usr   , _off^_usr   , _off^_usr   , _off^_usr   , _off^_usr   , _off^_usr   
_off^_usr   , _off^_usr   , _off^_usr   , _off^_usr   , _off^_usr   , _off^_usr   , _off^_usr   , _off^_usr   , _off^_usr   , _off^_usr   , _off^_usr   , Xv          , _off^_usr   , _off^_usr   , _off^_usr   , _off^_usr   , _off^_usr   , _off^_usr   , _off^_usr   , _off^_usr   , _off^_usr   , _off^_usr   , _off^_usr   
