border_size=1
usage=map

_s          , _s          , _s          , _s          , _s          , _s          , _s          , _s          , _s          , _s          , _s          , _s          , _s          , _s          , _s          , _s          , _s          , _s          , _s          , _s          , _s          , _s          , _s          , _s          , _s          , _s          , _s          , _s          , _s          
_s          , _s          , _s          , _s          , _s          , _s          , _s          , _s          , _s          , _s          , _s          , _s          , _s          , _s          , _s          , _s          , _s          , _s          , _s          , _s          , _s          , _s          , _s          , _s          , _s          , _s          , _s          , _s          , _s          
_s          , _s          , _s          , _s          , _s          , _s          , _s          , _s          , _s          , _s          , Uu^Ii       , Qxu         , Uu^Uf       , Uu^Ii       , Uu^Ii       , Uu^Ii       , Uh^Ii       , Ur^Ii       , Uu^Ii       , _s          , _s          , _s          , _s          , _s          , _s          , _s          , _s          , _s          , _s          
_s          , _s          , _s          , _s          , _s          , _s          , _s          , _s          , Uu^Ii       , Uu^Ii       , Ur          , Qxu         , Qxu         , Uu          , Xu          , Uu^Uf       , Ur          , Ur          , Xu          , Uu^Ii       , Uu^Ii       , _s          , _s          , _s          , _s          , _s          , _s          , _s          , _s          
_s          , _s          , _s          , _s          , _s          , _s          , Uu^Ii       , Uh^Ii       , Ur          , Ur          , Uh          , Ur          , Qxu^Bs\     , Uu          , Cud         , Xu          , Ur          , Rb          , Uu^Uf       , Xu          , Qxu         , Qxu         , Uu^Ii       , _s          , _s          , _s          , _s          , _s          , _s          
_s          , _s          , _s          , _s          , _s          , Ur^Ii       , Ur          , Ur          , Rb          , Uu^Uf       , Uu^Vud      , Qxu         , Uu^Uf       , Ur          , Ur          , Ur          , Rb          , Ur          , Ur          , Cud         , Qxu         , Uh          , Uu          , Uu^Ii       , _s          , _s          , _s          , _s          , _s          
_s          , _s          , _s          , _s          , Uu^Ii       , Uu^Ii       , Ur          , Uu^Uf       , Cud         , Rb          , Qxu         , Qxu         , Uh          , Rb          , Ur          , Uu^Uf       , Uh          , Cud         , Rb          , Ur          , Ur          , Qxu         , Uu          , Uu^Ii       , Uu^Ii       , _s          , _s          , _s          , _s          
_s          , _s          , _s          , _s          , Uu^Ii       , Uu          , Ur          , Rb          , Kud         , Rb          , Rb          , Uu          , Rb          , Rb          , Ur          , Uu^Vu       , Rb          , Xu          , Rb          , Uu          , Qxu         , Qxu^Bs\     , Ur          , Uu          , Uu^Ii       , _s          , _s          , _s          , _s          
_s          , _s          , _s          , Uu^Ii       , Uu          , Uu          , Qxu^Bs|     , Uu          , Qxu         , Qxu         , Xu          , Uu^Vu       , Ql^Bs|      , Ql^Bs|      , Ur          , Ql^Bs|      , Ql^Bs|      , Xu          , Xu          , Uu^Vu       , Qxu         , Uu          , Rb          , Ur          , Ur          , Ur^Ii       , _s          , _s          , _s          
_s          , _s          , _s          , Uu^Ii       , Uh          , Qxu         , Ur          , Qxu         , Uu^Vu       , Xu          , Ql          , Ql          , Cud         , Cud         , 1 Kud       , Cud         , Cud         , Ql          , Ql          , Xu          , Qxu         , Kud         , Cud         , Uu^Uf       , Ur          , Uu^Ii       , _s          , _s          , _s          
_s          , _s          , _s          , Qxu         , Qxu         , Qxu         , Ur          , Uu          , Rb          , Xu          , Ql          , Uu^Vud      , Ql          , Cud         , Cud         , Cud         , Ql          , Uu^Vud      , Ql          , Xu          , Rb          , Rb          , Rb          , Rb          , Ur          , Uh^Ii       , _s          , _s          , _s          
_s          , _s          , _s          , Uu^Ii       , Xu          , Cud         , Ur          , Rb          , Xu          , Xu          , Ql^Bs/      , Cud         , Cud         , Ql          , Cud         , Ql          , Cud         , Cud         , Ql^Bs\      , Uu^Vu       , Uu          , Qxu         , Uu^Vud      , Uu^Uf       , Ur          , Uu^Ii       , _s          , _s          , _s          
_s          , _s          , _s          , Uu^Ii       , Xu          , Uu^Uf       , Ur          , Cud         , Uh          , Rb          , Ql^Bs/      , Cud         , 2 Kud       , Cud         , Ql          , Cud         , 3 Kud       , Cud         , Ql^Bs\      , Rb          , Uh          , Qxu         , Qxu         , Uh          , Ur          , Uu^Ii       , _s          , _s          , _s          
_s          , _s          , _s          , Uu^Ii       , Ur          , Rb          , Ur          , Rb          , Uu^Uf       , Uu^Vu       , Ur          , Ur          , Cud         , Cud         , Ql          , Cud         , Cud         , Ur          , Ur          , Rb          , Rb          , Uu^Uf       , Qxu^Bs/     , Ur          , Qxu         , Uu^Ii       , _s          , _s          , _s          
_s          , _s          , _s          , Ur^Ii       , Uh          , Ur          , Xu          , Ur          , Ur          , Ur          , Rb          , Ql^Bs/      , Ql^Bs/      , Cud         , Uu^Vud      , Cud         , Ql^Bs\      , Ql^Bs\      , Uu^Vu       , Ur          , Ur          , Ur          , Uu          , Qxu         , Uu^Uf       , Qxu         , _s          , _s          , _s          
_s          , _s          , _s          , Uu^Ii       , Uu^Ii       , Uu^Uf       , Xu          , Cud         , Ur          , Rb          , Uh          , Rb          , Uu^Vu       , Ql          , Ql          , Ql          , Xu          , Re          , Uh          , Uu^Uf       , Ur          , Cud         , Xu          , Uu          , Uu^Ii       , Uu^Ii       , _s          , _s          , _s          
_s          , _s          , _s          , _s          , Uu^Ii       , Uu          , Uu          , Uu          , Qxu^Bs|     , Uu^Uf       , Qxu         , Uu          , Rb          , Xu          , Xu          , Xu          , Rb          , Xu          , Cud         , Rb          , Ur          , Xu          , Uu^Uf       , Uu          , Uu^Ii       , _s          , _s          , _s          , _s          
_s          , _s          , _s          , _s          , _s          , Uu^Ii       , Uu^Uf       , Qxu         , Ur          , Qxu         , Uu^Vud      , Qxu         , Rb          , Qxu         , Qxu         , Uu^Vu       , Uu          , Rb          , Ur          , Ur          , Rb          , Ur          , Uh          , Uu^Ii       , _s          , _s          , _s          , _s          , _s          
_s          , _s          , _s          , _s          , _s          , Uu^Ii       , Qxu         , Qxu         , Ur          , Uh          , Uu^Uf       , Rb          , Cud         , Kud         , Uu          , Qxu         , Ur          , Ur          , Cud         , Uu^Uf       , Xu          , Ur          , Ur^Ii       , Uu^Ii       , _s          , _s          , _s          , _s          , _s          
_s          , _s          , _s          , _s          , _s          , _s          , _s          , Uu^Ii       , Uu^Ii       , Ur          , Ur          , Rb          , Uu^Uf       , Rb          , Ur          , Qxu^Bs/     , Qxu         , Qxu         , Qxu         , Xu          , Uu^Ii       , Uu^Ii       , _s          , _s          , _s          , _s          , _s          , _s          , _s          
_s          , _s          , _s          , _s          , _s          , _s          , _s          , _s          , _s          , Uu^Ii       , Uh^Ii       , Ur          , Ur^Ii       , Ur          , Uu^Ii       , Uu          , Uu^Ii       , Uh          , Qxu         , Uu^Ii       , _s          , _s          , _s          , _s          , _s          , _s          , _s          , _s          , _s          
_s          , _s          , _s          , _s          , _s          , _s          , _s          , _s          , _s          , _s          , _s          , Uu^Ii       , _s          , Uu^Ii       , _s          , Uu^Ii       , _s          , Uu^Ii       , _s          , _s          , _s          , _s          , _s          , _s          , _s          , _s          , _s          , _s          , _s          
_s          , _s          , _s          , _s          , _s          , _s          , _s          , _s          , _s          , _s          , _s          , _s          , _s          , _s          , _s          , _s          , _s          , _s          , _s          , _s          , _s          , _s          , _s          , _s          , _s          , _s          , _s          , _s          , _s          
_s          , _s          , _s          , _s          , _s          , _s          , _s          , _s          , _s          , _s          , _s          , _s          , _s          , _s          , _s          , _s          , _s          , _s          , _s          , _s          , _s          , _s          , _s          , _s          , _s          , _s          , _s          , _s          , _s          
