border_size=1
usage=map

_s          , _s          , _s          , _s          , _s          , _s          , _s          , _s          , _s          , _s          , _s          , _s          , _s          , _s          , _s          , _s          , _s          , _s          , _s          , _s          , _s          , _s          , _s          , _s          , _s          
_s          , _s          , _s          , _s          , _s          , _s          , _s          , _s          , Md^Xm       , Md^Xm       , Md^Xm       , Md^Xm       , Md^Xm       , Md^Xm       , Md^Xm       , Md^Xm       , Md^Xm       , _s          , _s          , _s          , _s          , _s          , _s          , _s          , _s          
_s          , _s          , _s          , _s          , _s          , _s          , Wog         , Md^Xm       , Ss          , Wwg         , Ss          , Ss          , Ss          , Wwg         , Gd          , Md          , Gd^Fmw      , Md^Xm       , Md^Xm       , _s          , _s          , _s          , _s          , _s          , _s          
_s          , _s          , _s          , _s          , Md^Xm       , Md^Xm       , Ss          , Wwg         , Wwg         , Wwg         , Gd^Em       , Ss          , Ce          , Gd^Es       , Rp          , Rp          , Rp          , Gd          , Rd          , Md^Xm       , Chr         , _s          , _s          , _s          , _s          
_s          , _s          , _s          , _s          , Md^Xm       , Wwg         , Gd          , Ss^Vhs      , Wwg         , Gd^Fmw      , Rr          , Gd          , Gd          , Rp          , Ww          , Hhd^Fdw     , Wwg         , Rp          , Rp^Vhcr     , Re          , Re          , Chr         , 4 Khr       , _s          , _s          
_s          , _s          , _s          , Md^Xm       , Ss          , Ss          , Gd          , Gd          , Rp          , Wwg^Bsb/    , Gd          , Rr          , Rr          , Rp          , Md^Xm       , Ss          , Ss          , Gd          , Gd          , Rp          , Re          , Chr         , Chr         , _s          , _s          
_s          , _s          , Md^Xm       , Md^Xm       , Ss          , Hhd         , Gd^Es       , Rp          , Gd          , Wwg         , Wwg         , Gd^Vhr      , Rr          , Gd          , Md          , Md^Xm       , Md^Xm       , Gd^Es       , Gd          , Rp^Vhcr     , Rp          , Re          , Chr         , _s          , _s          
_s          , _s          , Md^Xm       , Ds          , Ds          , Hhd^Fdw     , Rp          , Rp          , Gd          , Gd^Fmw      , Wwf         , Gd          , Rr          , Gd          , Gd          , Md          , Md^Xm       , Md          , Gd^Es       , Gd          , Rp^Vhcr     , Re          , Md^Xm       , _s          , _s          
_s          , _s          , Md^Xm       , Dd^Vdt      , Dd          , Rp          , Ss          , Chs         , Wwg         , Gd          , Ds          , Wwg         , Rr^Vhc      , Ch          , Ch          , Gd          , Gd^Vhr      , Md^Xm       , Gd^Fmw      , Gd          , Rp          , Rd          , Md^Xm       , _s          , _s          
_s          , _s          , Md^Xm       , Dd          , Gd          , Rp          , Ww          , Wog         , Wwg         , Gd          , Ch          , Chw         , Chw         , 2 Kh        , Ch          , Gd          , Wwg         , Md^Xm       , Ww          , Rp          , Gd          , Hhd^Fdw     , Md^Xm       , _s          , _s          
_s          , _s          , Md^Xm       , Hhd^Fdw     , Rp          , Rp          , Gll^Fp      , Md^Xm       , Gd^Vhr      , Gd          , Ch          , 1 Kh        , Rr^Vhc      , Chw         , Ds          , Gd          , Wwg         , Wog         , Ss          , Rp          , Dd          , Dd          , Md^Xm       , _s          , _s          
_s          , _s          , Md^Xm       , Rd          , Rp^Vhcr     , Gd          , Gd^Es       , Md^Xm       , Md^Xm       , Gd          , Gd          , Ch          , Rr          , Wwg         , Wwf         , Gd          , Gd          , Chs         , Rp          , Rp          , Ds          , Dd^Vdt      , Md^Xm       , _s          , _s          
_s          , _s          , Chr         , Re          , Rp          , Gd          , Gd          , Md          , Md^Xm       , Md          , Md          , Gd          , Rr          , Gd          , Wwg         , Gd^Fmw      , Gd          , Rp          , Gd^Es       , Hhd^Fdw     , Ss          , Ds          , Md^Xm       , _s          , _s          
_s          , _s          , Chr         , Re          , Re          , Rp^Vhcr     , Re          , Gd^Es       , Ss          , Md^Xm       , Md^Xm       , Gd          , Rr          , Gd^Vhr      , Gd          , Wwg         , Rp          , Rp          , Gd          , Hhd         , Ss          , Md^Xm       , _s          , _s          , _s          
_s          , _s          , 3 Khr       , Chr         , Re          , Rp          , Rp^Vhcr     , Rb          , Wwg         , Ss          , Ww          , Rp          , Gd          , Rr          , Rr          , Wwg^Bsb/    , Wwg         , Gd          , Gd^Em       , Ss          , Md^Xm       , Md^Xm       , _s          , _s          , _s          
_s          , _s          , _s          , Chr         , Chr         , Re          , Rd          , Rp          , Rp          , Hhd^Fdw     , Rp          , Rp          , Ce          , Gd          , Gd          , Gd^Fmw      , Wwg         , Ss^Vhs      , Ss          , Wwg         , Md^Xm       , _s          , _s          , _s          , _s          
_s          , _s          , _s          , _s          , _s          , Md^Xm       , Md^Xm       , Gd          , Gd^Fmw      , Rp          , Gd          , Gd^Es       , Ss          , Ss          , Ss          , Wwg         , Ss          , Wwg         , Wog         , Md^Xm       , _s          , _s          , _s          , _s          , _s          
_s          , _s          , _s          , _s          , _s          , _s          , _s          , Md^Xm       , Md^Xm       , Md          , Md^Xm       , Wwg         , Md^Xm       , Ss          , Md^Xm       , Wwg         , Md^Xm       , Md^Xm       , _s          , _s          , _s          , _s          , _s          , _s          , _s          
_s          , _s          , _s          , _s          , _s          , _s          , _s          , _s          , _s          , Md^Xm       , _s          , Md^Xm       , _s          , Md^Xm       , _s          , Md^Xm       , _s          , _s          , _s          , _s          , _s          , _s          , _s          , _s          , _s          
_s          , _s          , _s          , _s          , _s          , _s          , _s          , _s          , _s          , _s          , _s          , _s          , _s          , _s          , _s          , _s          , _s          , _s          , _s          , _s          , _s          , _s          , _s          , _s          , _s          
