border_size=1
usage=map

Gg          , Gg          , Gg          , Gg          , Gg          , Gg          , Gg          , Gg          , Gg          , Gg          , Gg          , Gg          , Gg          , Gg          , Gg          , Gg          , Gg          , Gg          , Gg          , Gg          , Gg          , Gg          , Gg          , Gg          
Gg          , Gg          , Gg          , Gg          , Mm^Xm       , Gg          , Mm^Xm       , Gg          , Mm^Xm       , Gg          , Mm^Xm       , Gg          , Mm^Xm       , Gg          , Mm^Xm       , Gg          , Mm^Xm       , Gg          , Mm^Xm       , Gg          , Gg          , Gg          , Gg          , Gg          
Gg          , Gg          , Gg          , Mm^Xm       , Rp          , Mm^Xm       , Gg          , Mm^Xm       , Gg          , Mm^Xm       , Gg          , Mm^Xm       , 2 Gg        , Mm^Xm       , Gg          , Mm^Xm       , Gg          , Mm^Xm       , Gg          , Mm^Xm       , Gg          , Gg          , Gg          , Gg          
Gg          , Gg          , Gg          , Mm^Xm       , Gs^Fp       , Rp          , Gs^Fp       , Gg          , Gs^Fp       , Gg          , Gs^Fp       , Gg          , Gs^Fp       , Gg          , Gs^Fp       , Gg          , Gs^Fp       , Gg          , Gs^Fp       , Mm^Xm       , Gg          , Gg          , Gg          , Gg          
Gg          , Gg          , Gg          , Mm^Xm       , Gg          , Rp          , Rp          , Gg          , Gg          , Gg          , Gg          , Gg          , Gg          , Gg          , Gg          , Gg          , Gg          , Gg          , Gg          , Mm^Xm       , Gg          , Gg          , Gg          , Gg          
Gg          , Gg          , Gg          , Mm^Xm       , Gs^Fp       , Gg          , Rp          , Hh          , Gg          , Gg          , Gg          , Hh^Fp       , Gg          , Gg          , Gg          , Hh          , Gg          , Gg          , Gs^Fp       , Mm^Xm       , Gg          , Gg          , Gg          , Gg          
Gg          , Gg          , Gg          , Mm^Xm       , Gg          , Gg          , Gs^Fp       , Rp          , Rp          , Gs^Fp       , Gg          , Gg          , Gg          , Gs^Fp       , Gg          , Gg          , Gs^Fp       , Gg          , Gg          , Mm^Xm       , Gg          , Gg          , Gg          , Gg          
Gg          , Gg          , Gg          , Mm^Xm       , Hh          , Gg          , Gg          , Gg          , Ggf         , Rp          , Gg          , Gg^Fet      , Gg          , Gg          , Ggf         , Gg          , Gg          , Gg          , Hh          , Mm^Xm       , Gg          , Gg          , Gg          , Gg          
Gg          , Gg          , Gg          , Mm^Xm       , Gg          , Gs^Fp       , Gg          , Gg          , Gg          , Rp          , Gs^Fp       , Hh          , Gs^Fp       , Gg          , Gg          , Gg          , Gg          , Gs^Fp       , Gg          , Mm^Xm       , Gg          , Gg          , Gg          , Gg          
Gg          , Gg          , Gg          , Mm^Xm       , Hh^Fp       , Gg          , Gg          , Hh          , Gg^Fet      , Rp          , Rp          , Rp          , Rp          , Gg          , Gg^Fet      , Hh          , Gg          , Gg          , Hh^Fp       , Mm^Xm       , Gg          , Gg          , Gg          , Gg          
Gg          , Gg          , Gg          , Mm^Xm       , Gg          , Gg          , Gg          , Hh          , Gg          , Gg          , Gs^Fp       , Rp          , Gs^Fp       , Rp          , Gg          , Hh          , Gg          , Gg          , Gg          , Mm^Xm       , Gg          , Gg          , Gg          , Gg          
Gg          , Gg          , Gg          , Mm^Xm       , Hh          , Gs^Fp       , Gg          , Gg          , Ggf         , Gg          , Gg          , Hh          , Gg          , Rp          , Ggf         , Gg          , Gg          , Gs^Fp       , Hh          , Mm^Xm       , Gg          , Gg          , Gg          , Gg          
Gg          , Gg          , Gg          , Mm^Xm       , Gg          , Gg          , Gs^Fp       , Gg          , Gg          , Gg          , Gg          , Gg^Fet      , Gg          , Rp          , Rp          , Gg          , Gs^Fp       , Gg          , Gg          , Mm^Xm       , Gg          , Gg          , Gg          , Gg          
Gg          , Gg          , Gg          , Mm^Xm       , Gs^Fp       , Gg          , Gg          , Gg          , Gg          , Gs^Fp       , Gg          , Gg          , Gg          , Gs^Fp       , Gg          , Rp          , Rp          , Gg          , Gs^Fp       , Mm^Xm       , Gg          , Gg          , Gg          , Gg          
Gg          , Gg          , Gg          , Mm^Xm       , Gg          , Gg          , Gg          , Hh          , Gg          , Gg          , Gg          , Hh^Fp       , Gg          , Gg          , Gg          , Hh          , Rp          , Gg          , Gg          , Mm^Xm       , Gg          , Gg          , Gg          , Gg          
Gg          , Gg          , Gg          , Mm^Xm       , Gs^Fp       , Gg          , Gs^Fp       , Gg          , Gs^Fp       , Gg          , Gs^Fp       , Gg          , Gs^Fp       , Gg          , Gs^Fp       , Gg          , Gs^Fp       , Rp          , Gs^Fp       , Mm^Xm       , Gg          , Gg          , Gg          , Gg          
Gg          , Gg          , Gg          , Mm^Xm       , Gg          , Gg          , Gg          , Gg          , Gg          , Gg          , Gg          , Gg          , 1 Gg        , Gg          , Gg          , Gg          , Gg          , Rp          , Rp          , Mm^Xm       , Gg          , Gg          , Gg          , Gg          
Gg          , Gg          , Gg          , Mm^Xm       , Mm^Xm       , Mm^Xm       , Mm^Xm       , Mm^Xm       , Mm^Xm       , Mm^Xm       , Mm^Xm       , Mm^Xm       , Mm^Xm       , Mm^Xm       , Mm^Xm       , Mm^Xm       , Mm^Xm       , Mm^Xm       , Mm^Xm       , Mm^Xm       , Gg          , Gg          , Gg          , Gg          
Gg          , Gg          , Gg          , Gg          , Gg          , Gg          , Gg          , Gg          , Gg          , Gg          , Gg          , Gg          , Gg          , Gg          , Gg          , Gg          , Gg          , Gg          , Gg          , Gg          , Gg          , Gg          , Gg          , Gg          
Gg          , Gg          , Gg          , Gg          , Gg          , Gg          , Gg          , Gg          , Gg          , Gg          , Gg          , Gg          , Gg          , Gg          , Gg          , Gg          , Gg          , Gg          , Gg          , Gg          , Gg          , Gg          , Gg          , Gg          
