border_size=1
usage=map

_s          , _s          , _s          , _s          , _s          , _s          , Xos         , _s          , _s          , _s          , _s          , _s          , _s          , _s          , _s          , _s          , _s          , _s          , _s          , _s          , _s          , _s          
_s          , _s          , _s          , _s          , Xos         , Xos         , Gg^Fet      , Xos         , Xos         , _s          , _s          , _s          , _s          , _s          , _s          , _s          , _s          , _s          , _s          , _s          , _s          , _s          
_s          , _s          , Xos         , Xos         , Gg^Ve       , Gg^Fet      , Kv          , Gg^Fet      , Gg^Ve       , Xos         , Xos         , _s          , _s          , _s          , _s          , _s          , _s          , _s          , _s          , _s          , _s          , _s          
_s          , Xos         , Gg^Fet      , Gg^Fet      , Gs^Fp       , Gs^Fp       , Cv          , Gs^Fp       , Gs^Fp       , Gg^Fet      , Gg^Fet      , Xos         , _s          , _s          , _s          , _s          , _s          , _s          , _s          , _s          , _s          , _s          
_s          , Xos         , Gg^Fet      , Kv          , Cv          , Gs^Fp       , Cv          , Gs^Fp       , Cv          , Kv          , Gg^Fet      , Xos         , _s          , _s          , _s          , _s          , _s          , _s          , _s          , _s          , _s          , _s          
_s          , Xos         , Gg^Ve       , Gs^Fp       , Gs^Fp       , Cv          , Cv          , Cv          , Gs^Fp       , Gs^Fp       , Gg^Ve       , Xos         , _s          , _s          , _s          , _s          , _s          , _s          , _s          , _s          , _s          , _s          
_s          , Xos         , Gg^Fet      , Gs^Fp       , Cv          , Cv          , Cv          , Cv          , Cv          , Gs^Fp       , Gg^Fet      , Xos         , _s          , _s          , _s          , _s          , _s          , _s          , _s          , _s          , _s          , _s          
_s          , Xos         , Gg^Fet      , Kv          , Gs^Fp       , Gs^Fp       , Cv          , Gs^Fp       , Gs^Fp       , Kv          , Gg^Fet      , Xos         , _s          , _s          , _s          , _s          , _s          , _s          , _s          , _s          , _s          , _s          
_s          , Xos         , Xos         , Gg^Fet      , Gg^Ve       , Gs^Fp       , Kv          , Gs^Fp       , Gg^Ve       , Gg^Fet      , Xos         , Xos         , _s          , _s          , _s          , Xv          , _s          , _s          , _s          , _s          , _s          , _s          
_s          , _s          , _s          , Xos         , Xos         , Gg^Fet      , Gg^Fet      , Gg^Fet      , Xos         , Xos         , Uu^Vud      , Xos         , Xos         , _s          , _s          , _s          , _s          , _s          , _s          , _s          , _s          , _s          
_s          , _s          , _s          , _s          , _s          , Xos         , Xos         , Xos         , Xos         , Xos         , 3 Kud       , Xos         , Xos         , Xos         , Xos         , _s          , _s          , _s          , _s          , _s          , _s          , _s          
_s          , _s          , _s          , _s          , _s          , Xos         , Uu^Vud      , Xos         , Cud         , Cud         , Cud         , Cud         , Cud         , Xos         , Uu^Vud      , Xos         , _s          , _s          , _s          , _s          , _s          , _s          
_s          , _s          , _s          , _s          , _s          , Xos         , Xos         , 6 Kud       , Cud         , Cud         , Cud         , Cud         , Cud         , 5 Kud       , Xos         , Xos         , _s          , _s          , _s          , _s          , _s          , _s          
_s          , _s          , _s          , _s          , _s          , Xos         , Xos         , Cud         , Cud         , Cud         , Cud         , Cud         , Cud         , Cud         , Xos         , Xos         , _s          , _s          , _s          , _s          , _s          , _s          
_s          , _s          , _s          , _s          , _s          , Xos         , Xos         , Cud         , Cud         , Cud         , Cud         , Cud         , Cud         , Cud         , Xos         , Xos         , _s          , _s          , _s          , _s          , _s          , _s          
_s          , _s          , _s          , _s          , _s          , Xos         , Uu^Vud      , 4 Kud       , Cud         , Cud         , Cud         , Cud         , Cud         , 7 Kud       , Uu^Vud      , Xos         , _s          , _s          , _s          , _s          , _s          , _s          
_s          , _s          , _s          , _s          , _s          , Xos         , Xos         , Xos         , Xos         , Cud         , 2 Kud       , Cud         , Xos         , Xos         , Xos         , Xos         , _s          , _s          , _s          , _s          , _s          , _s          
_s          , _s          , _s          , _s          , _s          , _s          , _s          , Xos         , Xos         , Xos         , Uu^Vud      , Xos         , Xos         , Xos         , Wo          , Xos         , Xos         , _s          , _s          , _s          , _s          , _s          
_s          , _s          , _s          , _s          , _s          , _s          , _s          , _s          , _s          , Xos         , Xos         , Xos         , Ww^Vm       , Wo          , Khs         , Wo          , Ww^Vm       , Xos         , Xos         , _s          , _s          , _s          
_s          , _s          , _s          , _s          , _s          , _s          , _s          , _s          , _s          , Xos         , Wo          , Wo          , Ww          , Ww          , Chs         , Ww          , Ww          , Wo          , Wo          , Xos         , _s          , _s          
_s          , _s          , _s          , _s          , _s          , _s          , _s          , _s          , _s          , Xos         , Wo          , Khs         , Chs         , Chs         , Ss          , Chs         , Chs         , Khs         , Wo          , Xos         , _s          , _s          
_s          , _s          , _s          , _s          , _s          , _s          , _s          , _s          , _s          , Xos         , Ww^Vm       , Ww          , Chs         , Ss          , Ds          , Ss          , Chs         , Ww          , Ww^Vm       , Xos         , _s          , _s          
_s          , _s          , _s          , _s          , _s          , _s          , _s          , _s          , _s          , Xos         , Wo          , Ww          , Chs         , Ss          , Ss          , Ss          , Chs         , Ww          , Wo          , Xos         , _s          , _s          
_s          , _s          , _s          , _s          , _s          , _s          , _s          , _s          , _s          , Xos         , Wo          , Khs         , Ww          , Chs         , Chs         , Chs         , Ww          , Khs         , Wo          , Xos         , _s          , _s          
_s          , _s          , _s          , _s          , _s          , _s          , _s          , _s          , _s          , Xos         , Xos         , Wo          , Ww^Vm       , Ww          , Khs         , Ww          , Ww^Vm       , Wo          , Xos         , Xos         , _s          , _s          
_s          , _s          , _s          , _s          , _s          , _s          , _s          , _s          , _s          , _s          , _s          , Xos         , Xos         , Wo          , Wo          , Wo          , Xos         , Xos         , _s          , _s          , _s          , _s          
_s          , _s          , _s          , _s          , _s          , _s          , _s          , _s          , _s          , _s          , _s          , _s          , _s          , Xos         , Xos         , Xos         , _s          , _s          , _s          , _s          , _s          , _s          
_s          , _s          , _s          , _s          , _s          , _s          , _s          , _s          , _s          , _s          , _s          , _s          , _s          , _s          , _s          , _s          , _s          , _s          , _s          , _s          , _s          , _s          
